10000000200000000000000000000000000000000000000001
01000000200000000000000000000000000000000000000010
00100000200000000000000000000000000000000000000100
00010000200000000000000000000000000000000000001000
00001000200000000000000000000000000000000000010000
00000100200000000000000000000000000000000000100000
00000010200000000000000000000000000000000001000000
00000001200000000000033333300000000000000010000000
00000000100000000000000000300000000000000100000000
00000000210000000000003330300000000000001000000000
00000000201000000000000000300000000000010000000000
00000000200100000000000000300000000000100000000000
00000000200010000000000000000000000001000000000000
00000000200001000000000000000000000010000000000000
00000000200000166666600000077777777777700000000000
000000002666666666767000000000000077777000000000000
00000000266666601000000000000000077777000000000000
00000000200000000100000000000007777777000000000000
00000000200000000010000000000001000000000000000000
00000000200000000001000000000010000000000000000000
00000000200000000000100000000100000000000000000000
00000000200000000000010000001000000000000000000000
00000000200000000000001000010000000000000000000000
00000000200000000000000100100000000000000000000000
00000000200000000000000011000000000000000000000000
00000000200000000000000011000000000000000000000000
00000000200000000000000100100000000000000000000000
00000000200000000000001000010000000000000000000000
00000000200000000000010000001000000000000000000000
00000000200000000000100000000100000000000000000000
00000000200000000001000000000010000000000000000000
00000000200000000010000000000001000000000000000000
00000000200000000100000000000000100000000000000000
00000000200000001000000000000000010000000000000000
00000000200000010000000000000000001000000000000000
00000000200000100000000000000000000100000000000000
00000000200001000000000000000000000010000000000000
00000000200010000000000000000000000001000000000000
00000000200100000000000000000000000000100000000000
00000000201000000000000000000000000000010000000000
00000000210000000000000000000000000000001000000000
00000000100000000000000000000000000000000100000000
00000001200000000000000000000000000000000010000000
00000010200000000000000000000000000000000001000000
00000100200000000000000000000000000000000000100000
00001000200000000000000000000000000000000000010000
00010000200000000000000000000000000000000000001000
00100000000000000000000000000000000000000000000100
01000000000000000000000000000000000000000000000010
10000000000000000000000000000000000000000000000001