3333333333333333
3001111111111111
3001111111111111
3000111100000000
3000111110044444
3000001110022222
3000000000022222
3000000000022222
3000000000022222
3333333333322222
2222222222222222
2222222222222222